1 1 1 1 1 1 1 1 1 1 1 1 1 1 1 1 1 1 1 1 1 1 1 1
1 2 2 2 1 1 2 2 2 1 1 1 1 1 1 1 1 128 128 128 1 1 1 1
1 1 1 4 1 1 1 5 1 1 1 1 7 1 1 1 1 128 128 128 8 8 8 8
1 1 1 1 1 1 1 1 1 1 1 1 1 1 1 1 1 1 1 1 1 1 1 1
1 2 2 2 1 1 2 2 2 1 1 89 89 89 89 89 1 1 1 1 1 1 1 1
1 1 1 4 1 1 1 5 1 1 1 1 7 1 1 1 1 1 1 8 8 8 8 8
1 1 1 1 1 1 1 1 1 1 1 1 1 1 1 1 1 1 1 1 1 1 1 1
1 2 2 2 1 1 2 2 2 1 1 1 1 1 1 1 1 1 1 1 1 1 1 1
1 1 1 4 1 1 1 5 1 1 1 1 7 1 1 1 1 1 1 8 8 8 8 8
1 1 1 1 1 1 1 1 1 1 1 1 1 1 1 1 1 1 1 1 1 1 1 1
35 35 35 35 35 26 35 35 35 35  35 35 3 1 1 1 1 1 1 1 1 1 1 1
35 35 35 35 35 35 35 35 35 35 35 35 3 1 1 1 1 1 1 8 8 8 8 8
35 35 35 41 35 35 35 35 35 35 35 35 3 1 1 1 1 1 1 1 1 1 1 1
1 2 2 2 35 35 2 2 2 1 35 35 1 1 1 1 1 1 1 1 1 1 1 1
1 1 1 4 35 35 1 5 1 1 35 35 7 1 1 1 1 1 1 8 8 8 8 8
1 1 1 1 35 35 1 1 1 1 35 35 1 1 1 1 1 1 1 1 1 1 1 1
1 2 2 2 35 35 2 2 2 1 35 35 1 1 1 1 1 1 1 1 1 1 1 1
1 1 1 4 35 35 35 35 35 35 35 35 7 1 1 1 1 1 1 8 8 8 8 8
1 1 1 1 1 1 1 1 1 1 1 1 1 1 1 1 1 1 1 1 1 1 1 1
1 2 2 66 1 1 2 2 2 1 1 1 1 1 1 1 1 1 1 1 1 1 1 1
1 1 1 66 1 1 66 5 1 1 1 1 7 1 1 1 1 1 1 8 8 8 8 8
1 1 1 66 1 1 66 1 15 15 1 1 1 1 1 1 1 1 1 1 1 1 1 1
1 2 2 66 1 1 66 2 2 1 1 1 1 1 1 1 1 1 1 1 1 1 1 1
1 1 1 66 66 66 66 5 1 1 1 1 7 1 1 3 3 3 1 8 8 8 8 8
1 2 2 2 1 1 2 2 2 1 1 1 1 1 1 65 65 1 1 1 1 1 1 1
1 1 1 4 1 1 1 5 1 1 1 1 7 1 1 65 65 1 1 8 8 8 8 8
1 1 1 1 1 1 1 1 1 1 1 1 1 1 1 1 1 1 1 1 1 1 1 1
1 2 2 2 21 21 2 2 2 1 1 1 1 1 1 1 1 1 1 1 1 1 1 1
1 1 1 4 21 21 1 5 1 1 1 1 7 1 1 1 1 1 1 8 8 8 8 8
1 1 1 1 1 1 1 1 1 1 1 1 1 1 1 1 1 1 1 1 1 1 1 1
1 2 2 2 1 1 2 2 2 1 1 1 1 1 1 1 1 1 1 1 1 1 1 1
1 1 1 4 1 1 1 5 1 1 1 1 7 1 1 1 1 1 1 8 8 8 8 8