1 1 1 1 1 1 1 1 1 1 1 1 1 1 1 1 1 1 1 1 1 1 1 1
1 2 2 2 1 1 2 2 2 1 1 1 1 1 1 1 1 128 128 128 1 1 1 1
1 1 1 4 1 1 1 5 1 1 1 1 7 1 1 1 1 128 128 128 8 8 8 8
1 1 1 1 1 1 1 1 1 1 1 1 1 1 1 1 1 1 1 1 1 1 1 1
1 2 2 2 1 1 2 2 2 1 1 1 1 1 1 1 1 1 1 1 1 1 1 1
1 1 1 4 1 1 1 5 1 1 1 1 7 1 1 1 1 1 1 8 8 8 8 8
1 1 1 1 1 1 1 1 1 1 1 1 1 1 1 1 1 1 1 1 1 1 1 1
1 2 2 2 1 1 2 2 2 1 1 1 1 1 1 1 1 1 1 1 1 1 1 1
1 1 1 4 1 1 1 5 1 1 1 1 7 1 1 1 1 1 1 8 8 8 8 8
1 1 1 1 1 1 1 1 1 1 1 1 1 1 1 1 1 1 1 1 1 1 1 1
35 35 35 35 35 26 35 35 35 1 1 1 1 1 1 1 1 1 1 1 1 1 1 1
35 35 35 35 35 35 35 35 35 1 1 1 7 1 1 1 1 1 1 8 8 8 8 8
35 35 35 41 35 35 35 35 35 1 1 1 1 1 1 1 1 1 1 1 1 1 1 1
1 2 2 2 1 35 2 2 2 1 35 35 1 1 1 1 1 1 1 1 1 1 1 1
1 1 1 4 1 35 1 5 1 1 35 35 7 1 1 1 1 1 1 8 8 8 8 8
1 1 1 1 1 35 1 1 1 1 35 35 1 1 1 1 1 1 1 1 1 1 1 1
1 2 2 2 1 35 2 2 2 1 35 35 1 1 1 1 1 1 1 1 1 1 1 1
1 1 1 4 1 35 35 35 35 35 35 1 7 1 1 1 1 1 1 8 8 8 8 8
1 1 1 1 1 1 1 1 1 1 1 1 1 1 1 1 1 1 1 1 1 1 1 1
1 2 2 2 1 1 2 2 2 1 1 1 1 1 1 1 1 1 1 1 1 1 1 1
1 1 1 4 1 1 1 5 1 1 1 1 7 1 1 1 1 1 1 8 8 8 8 8
1 1 1 1 1 1 1 1 1 1 1 1 1 1 1 1 1 1 1 1 1 1 1 1
1 2 2 2 1 1 2 2 2 1 1 1 1 1 1 1 1 1 1 1 1 1 1 1
1 1 1 4 1 1 1 5 1 1 1 1 7 1 1 1 1 1 1 8 8 8 8 8
1 2 2 2 1 1 2 2 2 1 1 1 1 1 1 65 65 1 1 1 1 1 1 1
1 1 1 4 1 1 1 5 1 1 1 1 7 1 1 65 65 1 1 8 8 8 8 8
1 1 1 1 1 1 1 1 1 1 1 1 1 1 1 1 1 1 1 1 1 1 1 1
1 2 2 2 1 1 2 2 2 1 1 1 1 1 1 1 1 1 1 1 1 1 1 1
1 1 1 4 1 1 1 5 1 1 1 1 7 1 1 1 1 1 1 8 8 8 8 8
1 1 1 1 1 1 1 1 1 1 1 1 1 1 1 1 1 1 1 1 1 1 1 1
1 2 2 2 1 1 2 2 2 1 1 1 1 1 1 1 1 1 1 1 1 1 1 1
1 1 1 4 1 1 1 5 1 1 1 1 7 1 1 1 1 1 1 8 8 8 8 8