1   1   1   1   1   1   1   1   1   1   1   1   1   1   1   1   1   1   1   1   1   1   1   1   1   1   1   1   1   1   1   1
1   1   1   1   1   1   1   1   1   1   1   1   1   1   1   1   1   1   1   1   1   1   1   1   1   1   1   1   1   1   1   1
1   1   1   1   1   1   1   1   1   1   1   1   1   1   1   1   1   1   1   1   1   1   1   1   1   4   1   1   1   1   1   1
1   1   1   1   128 128 1   1   1   1   1   1   1   1   3   3   3   3   3   3   1   1   1   1   1   93  3   1   1   1   1   1
1   1   1   1   128 128 1   1   1   1   1   1   1   1   3   2   2   2   2   3   1   1   1   1   1   93  3   1   1   1   1   1
1   1   1   1   1   1   1   1   1   1   1   1   1   1   3   2   9   9   2   3   1   1   1   1   4   93  3   1   1   1   1   1
1   1   1   1   1   1   1   1   4   1   1   1   93  93  93  2   9   9   2   93  93  93  93  93  93  93  93  93  93  93  93  93
1   1   1   1   1   1   1   1   93  1   1   1   93  1   3   2   2   2   2   3   1   1   1   1   1   1   1   1   1   1   1   1
1   1   1   1   1   1   1   1   93  1   1   4  93  1   3   3   3   3   3   3   1   1   1   1   1   1   1   1   1   1   1   1
93  93  93  93  93  93  93  93  93  93  93  93  93  1   1   1   1   1   1   1   1   1   1   1   1   1   1   1   1   1   1   1
1   1   1   1   1   93  3  1   1   1   1   1   93  1   1   1   1   1   1   1   1   1   1   1   1   1   1   1   1   1   1   1
1   1   1   1   1   93  1   1   1   1   1   1   93  1   1   1   1   1   1   1   1   1   1   1   1   1   1   1   1   1   1   1
1   1   1   1   1   93  1   1   1   1   1   1   93  1   1   1   1   1   1   1   1   1   1   1   1   1   1   1   1   1   1   1
1   1   1   1   1   93  1   1   1   1   1   1   93  1   1   1   1   1   1   1   1   1   1   1   1   1   1   1   1   1   1   1
1   1   1   1   1   93  1   1   1   1   1   1   93  8   8   8   8   8   8   8   1   1   1   132 132 132 132 132 132 132 132 132
1   1   1   1   1   93  1   1   1   1   1   1   93  93  93  93  93  93  93  93  93  93  3   132 1   1   1   1   1   1   1   1
1   1   1   1   1   93  1   1   1   1   1   1   1   1   1   1   1   1   1   1   132 93  132 132 1   1   1   1   1   1   1   1
1   1   1   1   1   4   1   1   1   1   1   1   1   1   1   1   1   1   1   1   132 93  1   1   1   1   1   1   1   1   1   1
1   1   1   1   1   1   1   1   1   1   1   1   1   1   1   1   1   1   1   1   132 93  1   1   1   1   1   1   1   1   1   1
1   1   1   1   1   1   1   1   1   1   1   1   1   1   1   1   1   1   1   1   132 93  1   1   1   1   1   1   1   1   1   1
1   1   1   1   1   1   1   1   1   1   1   1   1   1   1   1   1   1   1   1   132 93  26  35  26  35  26  35  26  35  26  35
1   1   1   1   1   1   1   1   1   1   1   1   1   1   1   1   1   1   1   1   132 93  35  26  35  26  35  26  35  26  35  26
1   1   1   1   1   1   1   1   1   1   1   1   1   1   1   1   1   1   1   1   132 93  26  35  26  35  26  35  26  35  26  35
1   1   1   1   1   1   1   1   1   1   1   1   1   1   1   1   1   1   1   1   132 93  35  26  35  26  35  26  35  26  35  26

